         R  1024     768

 NO  ./Texture/NO_TECH_1A.xpm
    SO    ./Texture/SO_TECH_2A.xpm
  WE      ./Texture/WE_TECH_3A.xpm
 EA         ./Texture/EA_TECH_4A.xpm

 F  0  , 80 ,  50
  C     255  , 30  ,  0








         11111111111111111111111111111111
         10000000000000000000000000000001
         10000000000000000000000000000001
         10000000000000000000000000000001
         10000000000000000000000000000001
         10000000000000000000000000000001
         1000000000000000N000000000000001
         10000000000000000000000000000001
         10000000000000000000000000000001
         10000000000000000000000000000001
         10000000000000000000000000000001
         10000000000000000000000000000001
         11111111111111111111111111111111
