R 1024 768

NO ./Texture/NO_TECH_1A.xpm
SO ./Texture/SO_TECH_2A.xpm
WE ./Texture/WE_TECH_3A.xpm
EA ./Texture/EA_TECH_4A.xpm

F 40,0,120
C 0,90,190

                          1
                        110111
                       100011
         11111111111 11110111111
         1000000000010000000011
         1000000000110110000001
          11000000000000000001
         11000111000001000000111111111111111
          1001   10000000000000000000000000W1
         111111 1111111101111101111111111111
                       101   101
                       101   101
                       101   101
                        1    111
                        