NO ./Texture/NO_TECH_1A.xpm
SO ./Texture/SO_TECH_2A.xpm
WE ./Texture/WE_TECH_3A.xpm
EA ./Texture/EA_TECH_4A.xpm

R 3000 2000

C 6  185 ,  220
F 13  , 68 ,    131







     11111111111111111111111
    1000000000000000000000011
    100000000000000000000000011111111111111111111111111111111111111111111111111111111111111111111111111111111111111111111111111111111111111111111111111111111111111111111111111111111111111111111111111111
    1E0000000000000000000000000000000000000000000000000000000000000000000000000000000000000000000000000000000000000000000000000000000000000000000000000000000000000000000000000000000000000000000000000001
    100000000000000000000000011111111111111111111111111111111111111111111111111111111111111111111111111111111111111111111111111111111111111111111111111111111111111111111111111111111111111111111111111111
    11111111111111111111111111
