R 1024 768

NO ./Texture/NO_TECH_1A.xpm
SO ./Texture/SO_TECH_2A.xpm
WE ./Texture/WE_TECH_3A.xpm
EA ./Texture/EA_TECH_4A.xpm

F 0,0,0


    1111111  111111
    1000001  100001
    100001    10001
    100001    10001
    100001111110001
    100000000000001
    1000010E0100001
    100000000000001
    111111111111111
    
