R 1024 768

NO ./Texture/NO_TECH_1A.xpm
SO ./Texture/SO_TECH_2A.xpm
WE ./Texture/WE_TECH_3A.xpm
EA ./Texture/EA_TECH_4A.xpm

F 0,0,0
C 255,255,255





		00000000000000000000000000000000000000000000
		01111111111111111111111111111111111111111110
		01000000000000000000000000000000000000000010
		01000000000000000000000000000000000000000010
		01000000000000000000000000000000000000000010	
		0100000000000000000000000000W000000000000010	
		01000000000000000000000000000000000000000010
		01000000000000000000000000000000000000000010
		01111111111111111111111111111111111111111110
		00000000000000000000000000000000000000000000
