R 1024 768

NO ./Texture/NO_TECH_1A.xpm
SO ./Texture/SO_TECH_2A.xpm
WE ./Texture/WE_TECH_3A.xpm
EA ./Texture/EA_TECH_4A.xpm

F 0,0,0
C 255,255,255








      1111111111111111111111
     100000000000000000000001
    10000000000000000000000001
    10000000000000000000000001
    10000000000000000000000001
    10000000000000000000000001
    11111111111111111111111111



                11111111111111111111111111111
                100000000000000000000000000001
                10000000000000000000000000001
                100000000000000000000000N00001
                10000000000000000000000000001
                11111111111111111111111111111
