R 1024 768

F 255,255,255
C 0,0,0

1111111111111111111111
1000000000000000000011
1000000000100000000001
1100000000000111111111
1100000000000100000W11
1100010100000000000001
1111111111111111111111
