R 1024 768

NO ./Texture/NO_TECH_1A.xpm
SO ./Texture/SO_TECH_2A.xpm
WE ./Texture/WE_TECH_3A.xpm
EA ./Texture/EA_TECH_4A.xpm

F 0,0,0
C 255,255,255


11111111111 1111111111
1000000000000000000011
1000000000100000000001
1100000000000111111111
11000101000001000000111111111111111
11001   10000000000000000000000000W1
111111 1111111101111101111111111111
              101   101
              101   101
              101   101
               0    101
