F 0,0,0
C 255,255,255

R 800 600

NO ./Texture/NO_TECH_1A.xpm
SO ./Texture/SO_TECH_2A.xpm

WE ./Texture/WE_TECH_3A.xpm
EA ./Texture/EA_TECH_4A.xpm



         11111111111111111111111111111111
         10000000000000000000000000000001
         10000000000000000000000000000001
         10000000000000000000000000000001
         10000000000000000000000000000001
         1000000000000      000000000001
         1000000000000000N000000000000001
         1000000000000      0000000000001
         10000000000000000000000000000001
         10000000000000000000000000000001
         10000000000000000000000000000001
         10000000000000000000000000000001
         11111111111111111111111111111111
