R 100 0 400

NO ./Texture/BRICK_1A.xpm
SO ./Texture/BRICK_1A.xpm
WE ./Texture/BRICK_2A.xpm
EA ./Texture/BRICK_2A.xpm

F 42,200,0
C 42,211,255

        1111111111111111111111111
        1000000000110000000000001
        1011000001110000000000001
        1001000000000000000000001
111111111011000001110000000000001
100000000011000001110111111111111
11110111111111011100000010001
11110111111111011101010010001
11000000110101011100000010001
10001000000000001100000010001
10000000000000001101010010001111
1100000111010101111101111000N0111
11110111 1110101 1011110100011111
11111111 1111111 111111111111
